111111111111111111
100000111011111101
100001110011001101
100011100000011101
100111000000111001
101111111001110011
100000111001111111
100000000000000001
111111111111111111