1111111111111
1E0000P0C0011
1000000000001
1111111111111
1111111111111
1111111111111
1111111111111
1111111111111
