1111111111111111111111111111111111111
1000000000000000000000000000000000001
10000000000000000000000000000000P0001
1000000000000000000000000000000000001
10000000C0000000000000000000000000001
10000000E0000000000000000000000000001
1000011100011000100100010011110000001
1000100010010100100100010010001000001
1000100010010100100100010011110000001
1000100010010010100100010010100000001
1000100010010010100100010010010000001
1000011100010001100011100010001000001
1000000000000000000000000000000000001
1000000000000000000000000000000000001
1111111111111111111111111111111111111
